3
.........
....A....
....BA...
...AAB.C.
...BDAAC.
..AADEED.
..DDEDCC.
.AEEDCCD.
