2
........
....A...
....A...
....BA..
....CBB.
....BBA.
.CC.AAB.
